##############################################################
#              %     %       #           %    #              #
#%             %         ############    %     #             #
#%             %     %   #    #                              #
#%             %                                             #
#%                   %       %           %                   #
#                                                            #
#                                              #             #
#                                              #             #
##########                                     #             #
#% % % % %              #    #                 #             #
#%%#%#%#%##  #          #%%%%#                               #
##########              #%@%%#                               #
# %                     ######                               #
# %       #  #          #%%%%                                #
##############################################################