##############################################################
#@    #                      #                               #
#####%#                      #                               #
#%%%%%#                      #                               #
#%%%%%#                                                      #
#%#####                                                      #
#                                             ####           #
#   ####                                      ####           #
#    %%#                                      ####           #
#   #%%#                                      ####           #
#   #%%#                                                     #
#   #%%#                                                     #
#   #%%#                                         ########### #
#   ####                                         ##%%%%%%%%%%#
#                                                #%%%%%%%%%%%#
##############################################################